****************
*         *    *
*E   *    *  ***
*    *    *    *
*    *    *    *
*    *    *    *
*S   *         *
****************
